a	a
b	b
d	d
dz	dz
dh	dh
e	e
f	f
g	g
gj	gj
gh	gh
i	i
k	k
ks	ks
l	l
ll	ll
m	m
n	n
nj	nj
ng	ng
o	o
p	p
ps	ps
r	r
rr	rr
s	s
t	t
ts	ts
th	th
u	u
x	x
xj	xj
y	y
z	z